111111111
1C0000001
101P01E11
10000CM01
101001001
100000001
111111111