11111111111111
101CC010000001
10110C101E1C01
1CC0C00PM00001
11111111111111