1111111111111
100CC0110CCC1
10110C1010CC1
1E11000P0C001
1111111111111