11111111111111
11111100P11111
11111C011E1111
11111111111111